0100000000
0        0
0   22   0
0   2    0
0       20
02222    0
0        0
0  2   220
0  2     0
0000000010